#######
###P# #
###XO #
# X   #
# O XO#
#     #
#######
