#####
#OP #
#XX##
#   #
# X #
#  ##
# ###
#O ##
#O ##
#####
