#######
#     #
#   XP#
# O   #
# O X #
#######
