##########
##      ##
#   XX XP#
# X#  O###
# O#######
# O#######
# O# # ###
#  XO    #
##########
