##########
###  #####
### X### #
###    XP#
#### # X #
# X O  O #
# O  O   #
##########
